111111111111111111111111111111111111111111111111111111111111
10000000000000000000000000000000000000000C111111111111111111
100000000000000000000000000000000000000000111111111111111111
100000000000000000000000000000000000000011111111111111111111
100000000000000000000000000000000000000010111111111111111111
10000000000000000000000000000000000000000C111111111111111111
100000000000000000000000000000000000000010111111111111111111
100000000000000000000000000000000000111111111111111111111111
100000000000000000000000000000000000000000111111111111111111
100000000000000000000000000000000000000001111111111111111111
100000000000000000000000000000000000000000111111111111111111
100000000000000000000000000000000000000000111111111111111111
100000000000000000000000000000000000000000111111111111111111
10000000000000000000000000000000P000000000111111111111111111
100000000000000000000000000000000000000000111111111111111111
100000000000000000000000000000000000000000111111111111111111
1000000000000000000C0000000000000000000000111111111111111111
100000000000000000000000000000000000000000111111111111111111
100000000000000000000000000000000000000000111111111111111111
100000000000000000000000000000000000000000111111111111111111
110000000000000000000000000000000000000000111111111111111111
1101E0000000000000000000000000000000000000111111111111111111
110000000000000000000000000000000000000000111111111111111111
100000000B00000000000000000000000000000000111111111111111111
111111111111111111111111111111111111111111111111111111111111
111111111111111111111111111111111111111111111111111111111111
111111111111111111111111111111111111111111111111111111111111
111111111111111111111111111111111111111111111111111111111111
111111111111111111111111111111111111111111111111111111111111
111111111111111111111111111111111111111111111111111111111111
111111111111111111111111111111111111111111111111111111111111
111111111111111111111111111111111111111111111111111111111111