111111111111111111111
1P0000000100001000001
100111010101011110101
101000110101000000101
101011110101011111101
1010000100010100000E1
1C0011111111111111111
100000000000000000B11
111111111111111111111