111111111111111111111
1P0000000100001000001
101111010101011110101
101000010101000000101
101011110101011111101
1010000100010100000E1
1C0011111111111111111
1000000000000000000B1
111111111111111111111