1111111
1P00001
1110001
1100001
1E00001
1100001
11100C1
1111111