111111111111111
1PCCE0011111111
100000000000001
111110110000001
100000010000001
111111111111111