1111111111111111111111111111111111111111111111111111111111111
10000000000000000000000000000000000000000C1111111111111111111
1000000000000000000000000000000000000000001111111111111111111
1000000000000000000000000000000000000000111111111111111111111
1000000000000000000000000000000000000000101111111111111111111
10000000000000000000000000000000000000000C1111111111111111111
1000000000000000000000000000000000000000101111111111111111111
1000000000000000000000000000000000001111111111111111111111111
1000000000000000000000000000000000000000001111111111111111111
1000000000000000000000000000000000000000011111111111111111111
1000000000000000000000000000000000000000001111111111111111111
1000000000000000000000000000000000000000001111111111111111111
1000000000000000000000000000000000000000001111111111111111111
10000000000000000000000000000000P0000000001111111111111111111
1000000000000000000000000000000000000000001111111111111111111
1000000000000000000000000000000000000000001111111111111111111
1000000000000000000C00000000000000000000001111111111111111111
1000000000000000000000000000000000000000001111111111111111111
1000000000000000000000000000000000000000001111111111111111111
1000000000000000000000000000000000000000001111111111111111111
1100000000000000000000000000000000000000001111111111111111111
1101E00000000000000000000000000000000000001111111111111111111
1100000000000000000000000000000000000000001111111111111111111
1000000000000000000000000000000000000000001111111111111111111
1111111111111111111111111111111111111111111111111111111111111
1111111111111111111111111111111111111111111111111111111111111
1111111111111111111111111111111111111111111111111111111111111
1111111111111111111111111111111111111111111111111111111111111
1111111111111111111111111111111111111111111111111111111111111
1111111111111111111111111111111111111111111111111111111111111
1111111111111111111111111111111111111111111111111111111111111
1111111111111111111111111111111111111111111111111111111111111