111111111111111111111111111111111111111111111111111111111111111111111111111111111111111111111111111111111111111111111111111111111111111111111111111111111111111
1P0000000000000000000000000000000000000000000000000000000000000000000000000000000000000000000000000000000000000000000000000000000000000000000000000000000000001
101111111111111111111111111111111111111111111111111111111111111111111111111111111111111111111111111111111111111111111111111111111111111111111111111111111111111
101000000000000000000000000000000000000000000000000000000111111111111111111111111111111111111111111111111111111111111111111111111111111111111111111111111111111
1010101010101010101010101010101010101010101010101010101B1111111111111111111111111111111111111111111111111111111111111111111111111111111111111111111111111111111
101010101010101010101010101010101010101010101010101010100111111111111111111111111111111111111111111111111111111111111111111111111111111111111111111111111111111
101010101010101010101010101010101010101010101010101010101111111111111111111111111111111111111111111111111111111111111111111111111111111111111111111111111111111
101010101010101010101010101010101010101010101010101010101111111111111111111111111111111111111111111111111111111111111111111111111111111111111111111111111111111
101010101010101010101010101010101010101010101010101010101111111111111111111111111111111111111111111111111111111111111111111111111111111111111111111111111111111
101010101010101010101010101010101010101010101010101010101111111111111111111111111111111111111111111111111111111111111111111111111111111111111111111111111111111
101010101010101010101010101010101010101010101010101010101111111111111111111111111111111111111111111111111111111111111111111111111111111111111111111111111111111
101010101010101010101010101010101010101010101010101010101111111111111111111111111111111111111111111111111111111111111111111111111111111111111111111111111111111
101010101010101010101010101010101010101010101010101010101111111111111111111111111111111111111111111111111111111111111111111111111111111111111111111111111111111
101010101010101010101010101010101010101010101010101010101111111111111111111111111111111111111111111111111111111111111111111111111111111111111111111111111111111
100000000000000000000000000000000000000000000000000000001111111111111111111111111111111111111111111111111111111111111111111111111111111111111111111111111111111
101010101010101010101010101010101010101010101010101010101111111111111111111111111111111111111111111111111111111111111111111111111111111111111111111111111111111
101010101010101010101010101010101010101010101010101010101111111111111111111111111111111111111111111111111111111111111111111111111111111111111111111111111111111
101010101010101010101010101010101010101010101010101010101111111111111111111111111111111111111111111111111111111111111111111111111111111111111111111111111111111
101010101010101010101010101010101010101010101010101010101111111111111111111111111111111111111111111111111111111111111111111111111111111111111111111111111111111
101010101010101010101010101010101010101010101010101010101111111111111111111111111111111111111111111111111111111111111111111111111111111111111111111111111111111
101010101010101010101010101010101010101010101010101010101111111111111111111111111111111111111111111111111111111111111111111111111111111111111111111111111111111
101010101010101010101010101010101010101010101010101010101111111111111111111111111111111111111111111111111111111111111111111111111111111111111111111111111111111
10101010101010101010101010101010101010101010101010101C101111111111111111111111111111111111111111111111111111111111111111111111111111111111111111111111111111111
101010101010101010101010101010101010101010101010101010101111111111111111111111111111111111111111111111111111111111111111111111111111111111111111111111111111111
101010101010101010101010101010101010101010101010101010101111111111111111111111111111111111111111111111111111111111111111111111111111111111111111111111111111111
101010101010101010101010101010101010101010101010101010101111111111111111111111111111111111111111111111111111111111111111111111111111111111111111111111111111111
101010101010101010101010101010101010101010101010101010101111111111111111111111111111111111111111111111111111111111111111111111111111111111111111111111111111111
101010101010101010101010101010101010101010101010101010101111111111111111111111111111111111111111111111111111111111111111111111111111111111111111111111111111111
101010101010101010101010101010101010101010101010101010101111111111111111111111111111111111111111111111111111111111111111111111111111111111111111111111111111111
1010101010101010101010101010101010101010101010101010101E1111111111111111111111111111111111111111111111111111111111111111111111111111111111111111111111111111111
111111111111111111111111111111111111111111111111111011111111111111111111111111111111111111111111111111111111111111111111111111111111111111111111111111111111111
100000000000000000000000000000000000000000000000000000001111111111111111111111111111111111111111111111111111111111111111111111111111111111111111111111111111111
101010101010101010101010101010101010101010101010101010101111111111111111111111111111111111111111111111111111111111111111111111111111111111111111111111111111111
101010101010101010101010101010101010101010101010101010101111111111111111111111111111111111111111111111111111111111111111111111111111111111111111111111111111111
101010101010101010101010101010101010101010101010101010101111111111111111111111111111111111111111111111111111111111111111111111111111111111111111111111111111111
101010101010101010101010101010101010101010101010101010101111111111111111111111111111111111111111111111111111111111111111111111111111111111111111111111111111111
101010101010101010101010101010101010101010101010101010101111111111111111111111111111111111111111111111111111111111111111111111111111111111111111111111111111111
101010101010101010101010101010101010101010101010101010101111111111111111111111111111111111111111111111111111111111111111111111111111111111111111111111111111111
101010101010101010101010101010101010101010101010101010101111111111111111111111111111111111111111111111111111111111111111111111111111111111111111111111111111111
10101010101010101010101010101010101010101010101010101C101111111111111111111111111111111111111111111111111111111111111111111111111111111111111111111111111111111
111111111111111111111111111111111111111111111111111011111111111111111111111111111111111111111111111111111111111111111111111111111111111111111111111111111111111
100000000000000000000000000000000000000000000000000000001111111111111111111111111111111111111111111111111111111111111111111111111111111111111111111111111111111
101010101010101010101010101010101010101010101010101010101111111111111111111111111111111111111111111111111111111111111111111111111111111111111111111111111111111
101010101010101010101010101010101010101010101010101010101111111111111111111111111111111111111111111111111111111111111111111111111111111111111111111111111111111
101010101010101010101010101010101010101010101010101010101111111111111111111111111111111111111111111111111111111111111111111111111111111111111111111111111111111
101010101010101010101010101010101010101010101010101010101111111111111111111111111111111111111111111111111111111111111111111111111111111111111111111111111111111
101010101010101010101010101010101010101010101010101010101111111111111111111111111111111111111111111111111111111111111111111111111111111111111111111111111111111
101010101010101010101010101010101010101010101010101010101111111111111111111111111111111111111111111111111111111111111111111111111111111111111111111111111111111
101010101010101010101010101010101010101010101010101010101111111111111111111111111111111111111111111111111111111111111111111111111111111111111111111111111111111
10101010101010101010101010101010101010101010101010101C101111111111111111111111111111111111111111111111111111111111111111111111111111111111111111111111111111111
111111111111111111111111111111111111111111111111111111111111111111111111111111111111111111111111111111111111111111111111111111111111111111111111111111111111111